42 18 25
And another offering from Oz
##########################################
#>>>O.......:......O......O......O......O#
#+>>O....../*......:......:......:......:#
#.+>O...../*....>O\#.O....#......#.####.##
#..+*..../*.O....:..............\..\OO*O/#
#O.+.....*..:.....................\#OOOO##
#:.+.....................##O##O#....\O:/##
#*.+.C...................#.:.*<#........##
#..+...........O....##...#.##C.#.........#
#..+...........:/=\.*.=..#>*####....\../.#
#.....>*...........\=/.........O....\../*#
#...#......#@#.......................\/###
#..........#.#..S.S.S.S.S.S.S.S.....#.OOT#
#..........#.#.################.O.....O:##
#..........#.#.#O#.:<.#:#...O.....##..O..#
#.#.*.#....#.#.#:...#...#..#.#.#>*.#.#:#.#
#*#*#*#....#M#*#A#.###.X#..#*..#.#.#.***C#
##########################################
