42 18 5000
At the time of writing,-my last screen. -Steve
##########################################
#...........!..!..^..#===#........::.....#
#.===.===.==#..!*.^..:OOO!.====#..O:.#=#.#
#.S...!*!......#..*...OO<!<<*.T!..:O.!O!.#
#.*.==/.\===#\....^...\OO/.====#..!=.!^!.#
#*/*....O<<<!/....^....^^.........!..#=#.#
#.......*:..O.....*..:::::*....#==#......#
#+=#.#.!^!..*.....^............#....O:*:*#
#*.!.#..^...:.....^.....:::*<<<<::::\....#
#S:!.#......:\....+...\................./#
#:.!.#=#==@===\......./\......**......./^#
#==#...!......*\.....#==#.....^^....../^^#
#....*.!..*!....\.../<^^>\.../!.\/OO\/^^^#
#.#====#./.!...*<\./<<OO>>\./.!..\::/^^*^#
#.^^^*<./..!<=====X========>O:........^^^#
#T!^:::/\..!....>/^\*:.OO*>O\^!../..\..==#
#*!A.*<**>*!.O.*/^O^\O*:O*.::*../\*:/\..*#
##########################################
