42 18 7
Kenton's swan song.
##########################################
#C......OOO........+\*/:O:::::O::=......X#
#......@=.=....=..:O/O\::=::O=T=:===::===#
#C.+>....^..\.....:/*O*\::=**=*=:=******=#
#...........:..=../O***O\:=**=:=:=**::**=#
#C..>.............\*OOO*/:====:=:======*=#
#..............=S..\OOO/:::O<=:=:=::::::=#
#C..................\O/*:==O*=:=:=:======#
#...>....^........O./T\*:::O.=:=:=:=O====#
#.......\./......==.\O//:=====:=:=:*....*#
#/:\.....=........../^A:<::::=:=:=====.==#
#..^.S............./O..:====:=:=:=.*.....#
#\...=::O*:*O*:O...<<..::::=:=:=:=.===:=:#
#........OO....:...==.====:=:=:=:=M..*:=:#
#.....*.OOO=======*=*.***=:=:=:=:=======:#
#*..*..OOO**:**>**^:\..<<=:=:=:=*::::::::#
#^.=^=.****=*:***:=:....<=*=:::=^========#
##########################################
