42 18 750
My favourite one of the lot -Steve
##########################################
#...====>*O........O<.........../O:......#
#.*.......:*......*<..../........*<.....O#
###<....../..................*<\.......O/#
#*...........................O<.......O/*#
#########.#\.###............OO======.O/.O#
#AOO*OOO/*<<#...............*/.....**/.*/#
#\OO!OO/:.*#....../\......O#:...*.../....#
#*\OOO/::\*....../#O\./...:#\....../.....#
#..\O/.@..*...../O*<#*.OO#...\..../....\.#
#*.:::...*......#O<..##\O#....\**/.....!*#
#.::/:O#.......#.O.*....:.*/...><......!!#
#../#.*.......:##O##.######O.\..........*#
#..###\.....::::#O#:.:::::::::#####::#####
#::OOO#...::::#:::::/>>::O../##O*O:*::O*O#
#::*OOO.::::!:#*##.##/*<!!..#!*O:*::O:*:*#
#*::::*O::::::#:#*>T*......X#.O:*::*::O:*#
##########################################
