42 18 0
The Water System
##########################################
#T*****O#**#....#.......................=#
######OO#.<#....#....O*O*O.#............=#
#X...#OO#OO#...O#.........O#............=#
###OO#OO#OO#.OOO#.........O#*...........=#
#*#OO#OO#OO#.\O/#O....O.O..#*.....*.....=#
#O#OO#\O#OO#.#O>>..........#...*........=#
#..\*.#***/..OOO#......#.#.#^^^^^^^^^^^.=#
#...*:......#OO/#......#...#^^^^^^^^^^^.=#
#...*:.::\.^#\**#....#..../#^^^^^^^^^^^.=#
#.......#.:\.........#../OO#^^^^^^^^^^^.=#
#.#^#..##...#.###....\./OO/#^*^^^^^^^^^.=#
#.#*#..###*.#.#O#.....<<<<<#^^^^^*^^^^^.=#
#.##....#.^.#...#.....<<<<<#^^^^^^^^^^^.=#
#.##..\.../.#../####*#.#.###^^^^^^^^^^^..#
#.##.*\**.\.#>.....<#**<*..##^^^^^^^^^^^.#
#*##.^.^^\A.#^^#......###*##@............#
##########################################
