42 18 1000
Unnamed level.
##########################################
#O..>O*......O...O...**..>.........OOOO*O#
#O...>>OO<...\<!!O!!!:*\........<..>O*O<:#
#**....::......OOO...#..\..../......:::::#
###\...........OO*<..#./..>**<...\..*OOO<#
#*....\>>>.....OO..>OO/...>**\....\..::::#
#O.....\**<........::**............\.*<*:#
#...>...\!!!!!O...O###<#####O####<.#######
#.......::\O*:\...:!*::#>::*<####.::<::::#
#>>:...........\....\:#>*:>:::::\.::::#\<#
#.###:*#....O...\O:O*:######::!::\###::#:#
#>#O*####...:.O..\*:*<OO##*>*..::::::::*<#
#:::O::##\....:...\**@:*..##T####!::!##:##
#.O.:#*<<#\>>*O.O..\####:...!O#O*####O.###
#*:.:#:*<<*\*#O#*!...:##:OOOO:::::O:OO.O<#
#.!!###O#####OO######.:#:::OO:!##O::::::A#
#*..:::::::*::*:::.::::#*::*::O*:::!!!::X#
##########################################
