42 18 300
Unnamed level.
##########################################
#########OOOOOOOOOOOOO####################
######.O.****OOOOOOOOOO**********=======##
##...............O................#*****##
##.####.O.\OOOOOOOOOO/...*********#:######
##.#OOOO/...OOOOOOOO/..#.\<\<\<\<\****M###
##.#OOO/...#\OOOOOO/../#..#########/...<*#
##.#OO/#.###..OOOO/../##....#OO.O.....#O##
##.:O/*****#...OO*../#O#..#..**.*....A#O##
##.:/*******#OOO/.....*...#######.#:#.#O##
##./*******OOOOO#.############..#.#:#.#O##
##.########OOOOO#.##O#O#O#O#O#.##.#C#.#O##
##..#**####OOOOO#.##O#O#O#O#O#....#:#..**#
##\..#.#...*****:.##O#O#O#O#O#.####:##*/##
#>>>T..#..:.....:.O:*:*:*:*:*.@#>.\*****##
###.##.#\::::::::.###############>OO/***##
###.X#..::#:::::::::.................#**##
##########################################
