42 18 600
Unnamed level.
##########################################
#O................O.*#OO#####*........<..#
#:.####:####O##.##:.#.....O<####O#>.....:#
#..#*.....:::<#..:#.#..................O.#
#..##....#:::*#..><<##..##.#######.#...O<#
#\.......=====#........#>>.#..O..#.#.....#
#*...........@:..::..####..#.>:./#*>.....#
##OO/....>....#..::..#::#.....:.*####.:..#
#X::..OOO...*<#.........#>...\==.#:.O.#*##
#========<============..#..#....:\##O#####
##TOSS!##:##*.O/..*<<#..##.#####.........#
#..<==:.....#....:.#.#.....#OOO*####.#####
##..*...:<<.#...!<:#*#######OOO/OO...#..C#
##.#..+!!...#...::<:##*.....\O/.::...#.O.#
##.>:.#O#.#.#>......O*#\...><<...........#
##.##+#O#.#.##..OOO.:##..........\##.##:<#
##.....:..#................./\....*#A*##*#
##########################################
