42 18 50
Unnamed level.
##########################################
#*<>*\OO*OOOOOS....C+#.O*#........O..@SS*#
#OO...\OOO/>*:......*#>*.#.######:::#*#*##
#O/+<..\O/.>>*<<<<<OO<<#.#:O....#*.+#:*:##
#*.:<...+...........O<.#.#>*O/#...#.....##
#:#:#...O...../..!..*#!#.#>*/##O#...###.##
#>>+..!/:\.X+........#.#.##:::.C####....##
#OO#O./.O..####\..../#.O..*<:*#......#####
#OO.*...:\...###\....*<<:#M>:/#######..O##
#O...*\O...\..:O:.*<<<<>*:#............C<#
#*../..\O./...#*###..#..#:############::##
#.......\+<..#:S:::#...>T*..............##
#.############S#C#S##O#O#O#O#O#O#O#O#O#O##
#*<<<<<<<<<<*#:S:S:#>*::::::::::::::::::+#
###O#O#O#O#O############O#O#O#O#O#O#O###A#
#C:::::::::::::::::::::::::::::::::::::::#
#>*>*>*>*>*>*::!::!:!:/::::!:!:!:!:>C:::/#
##########################################
