42 18 0
Unnamed level.
##########################################
#.O..>>>\!*!...\...S.../.*/<<#O#O#O.****##
#..............O...!...O.....#:.:.:.\OOO##
##.#.....#.O####*#######.................#
#>>>>/...O.>.....:......../###:::\######.#
##.#*#<<<###.#####./#######...OOO#...O...#
#.*\.....*#*.#.>...#........+.*......###.#
#.#O\######..#./##*#S###O##.../OO##\.*#..#
#......*O..O.#.#T*#.*.#>O+*#####/.*#.#*./#
######.###.#*#.#*!#M..##.\OOO/*\..#O.##.*#
#..*+**...*###.#.O###O/.A............#+#.#
#..\###\.#...#.#TO#O.:..#/OOO\./######...#
#.......\#.#O#.#.:..@##*#####/.\#S.*+..O.#
#.+.....#/...:.\####.###/.....<.#.#.#:#:##
#.+.#.O.#....#.....\#/..../####.#S#+..#S##
#.+...#<#..O.\###\...S./##......#####.#.##
#S.S.S..*....*****##X##***>>>>......*.*..#
##########################################
