42 18 200
Unnamed level.
##########################################
#...^^.........^O:O^/<<<#........#S...#.X#
#...^:..........^*^O<<<<######.#.#.####..#
#....#>\....O/\*<<<</\O..#...#.#.#.#.....#
#...S#::\...>O*#####*O<.#..#.#.#.#.#####.#
#..S##*::O...^^.*O*.^^.#...#..S#.......#.#
#..S#*:O::.......#....#..###.#########.#.#
#..S#>^^::...........#S....###.....S.#.S.#
#O.S#########.#...*@######......####.#####
#O:..++++C+T#*#...O#**###O###.#.#..#.....#
#:OO..######*#*#.O#:........#S#.#..#.###O#
#*::.............#:O..#####.#####....****#
##################*:..#***#.....########O#
#####O##########*#O:^^#OOO#:###.........:#
#...***.##.::O::^OO^^^^^^^...*###O*OOO##.#
#<<<.A.<<<.>O^^O*OO*::.....:##::OO:<::::##
#..!!*!!...*::^O*::::##***###C:::::::::S:#
##########################################
