42 18 0
Unnamed level.
##########################################
#**:***:*:**..OO....X......./.#.##########
#:***!*.O..*...../....+.......:...O.....*#
#*!T*:*....#.........@...../:.#......./..#
#:**!**..#^#.......+======/.:.#......O...#
#***:*!.//.#..#.#....*.../....#.^....\...#
#!**!**.#..^..\*#\...^....:/....:^/....O.#
#......:.^/.....<#.......>/..>.........\.#
#...*^/../O#*^#*O.....:.......<..<......:#
#.S..#>./*.######.../...........<*....#..#
#.#..O^.=/............/.../======/....#.##
#.............\....<>/.../.O.O....../.#^##
####....##:#S....O.A.....#*.O#...../...#*#
#OO#>.\..S........./.\...#*.OO#.../+.....#
#..#............../.......#^.:......\..*.#
#..#...>............\.....*../......^\..*#
#....\..*.......T^#..........O.../*.T....#
##########################################
