9 9 35
Example
#########
#...#.*##
#.#.#.###
#.#.....#
#.####.##
#@#.....#
####.##.#
#*...#*.#
#########
